0,2,1,0,0
0,0,2,1,0
0,0,1,0,9
5,0,0,0,0
0,0,0,0,0